111111111111111
100000101010101
1P0C00000000001
110000011110001
1E00000CCCC1111
111111111111111
